
NO ./textures/purple.xpm
SO ./textures/blue.xpm
WE ./textures/wood.xpm
EA ./textures/grey.xpm




F 224,172,105
C 205,249,255




11111111111111111
10000000000000001
10010000000000001
10000000000000001
10000000001000001
10000100000000001
10000000000000001
10000000000000001
10000000000000001
10000000N00000001
10000000000000001
11111111111111111
